RR,RC,YS,GC,WH,YH,YR,GS,YR,WS
RS,YR,BS,BH,RR,RH,RR,YS,GC,BC
WR,RH,WC,GH,YR,GR,WR,BR,WH,RC
WH,RR,BC,RH,GC,WC,GC,WR,GH,BS
BR,WR,WS,WC,YH,WH,RC,RS,GS,RS
RC,WH,WR,BR,GH,WS,YH,BC,YR,GR
YR,GS,BH,GH,WH,YC,GR,RH,BR,RR
BS,YH,BS,RR,GR,WC,RC,YS,GS,YR
WS,BR,WC,RH,GH,WS,RR,WH,WC,BR
YS,RC,GS,YS,GC,YS,YR,WS,YS,YC
RH,GC,YH,GR,YC,BH,YH,YH,YS,GS
RR,BH,RH,GC,BR,BC,WS,GH,BH,BC

