XX,XX,GR,BC,RS,GH,XX
XX,GR,WS,BC,YS,WR,XX
XX,WR,BH,WC,GH,YR,RR
GS,BC,BH,BS,GC,RS,BS
XX,YH,GC,GS,RR,YH,BR
XX,YS,WR,WS,RH,BH,XX
XX,XX,RH,WC,GC,RH,XX