XX, XX, XX, XX, BC, XX, XX, XX, XX 
 XX, XX, YR, GC, WC, XX, XX, XX, XX 
XX, XX, WS, RR, BC, YC, RR, XX, XX 
 YR, BR, YS, WC, WC, YS, YS, XX, XX 
BS, GC, YR, RS, WC, WR, WC, BS, RC 
 WR, RS, RS, RR, GC, YS, RR, XX, XX 
XX, XX, RC, WS, GR, GR, BS, XX, XX 
 XX, XX, WR, RC, YR, XX, XX, XX, XX 
XX, XX, XX, XX, WR, XX, XX, XX, XX 