XX,XX,XX,XX,XX,XX,XX
XX,GR,BC,RS,GH,XX,XX
XX,GR,WS,BC,YS,WR,XX
WR,BH,WC,GH,YR,RR,XX
GS,BC,BH,BS,GC,RS,BS
YH,GC,GS,RR,YH,BR,XX
XX,YS,WR,WS,RH,BH,XX
XX,RH,WC,GC,RH,XX,XX