XX,XX,RH,GC,WC,RH,XX
XX,BH,RH,WS,WR,YS,XX
XX,BR,YH,RH,GS,GC,YH
BS,RS,GC,BS,BH,BC,GS
XX,RR,YR,GH,WC,BH,WR
XX,WR,YS,BC,WS,GR,XX
XX,XX,GH,RS,BC,GR,XX
